NO ./xpm/eagle.xpm
SO ./xpm/bluestone.xpm
WE ./xpm/redbrick.xpm
EA ./xpm/wood.xpm
C 50,50,50
F 75,75,75
1111111111111111111
1000000000000000001
10000000N0000000001
1000000000000000001
1000000000000000001
1111111111111111111
