NO ./xpm/eagle.xpm
SO ./xpm/bluestone.xpm
WE ./xpm/redbrick.xpm
EA ./xpm/wood.xpm




C 50,50,50
F 75,75,75




11111111111111111111111111111
10000000000000010000000000001
10000000000000010000000000001
10000000000000010000000000001
10000010000001010000000000001
10000000000010100000000000001
1000000000010N010000111111111
10000000000000000000000000001
11111100000000000000000000001
10000001000000000000111111111
10000001000000000000000000001
11111111111111111111111111111