NO ./xpm/eagle.xpm
SO ./xpm/bluestone.xpm
WE ./xpm/redbrick.xpm
EA ./xpm/wood.xpm

C 50,50,50
F 75,75,75	

1111111111111
1001000000001
1000100000001
1000010111111
1000001000001
1000100000001
1N00010000001
1111111111111