NO ./xpm/eagle.xpm
SO ./xpm/bluestone.xpm
WE ./xpm/redbrick.xpm
EA ./xpm/wood.xpm
F 125,125,0
C 0,255,255

111111111111111111111111111111111111111
100000000000000000000000000000000000001
100000000000000000000000000000000000001
100000000000000000000000000000000000001
100000000000000000000000000000000000001
100000010101010000101010100000000000001
100000000000000000000000000000000000001
100000000000000000000000000000000000001
100000000000000100000000000000000000001
100000000000001010000000000000000000001
100000000000010N01000000000000000000001
100000000000000000000000000000000000001
100000000000000000000000000000000000001
100000000000000000000000000000000000001
100000000000000000000000000000000000001
100000000000000000000000000000000000001
100000000000000000000000000000000000001
100000000000000000000000000000000000001
100000000111111111111000000000000000001
100000000000000000000000000000000000001
100000000000000000000000000000000000001
111111111111111111111111111111111111111
