NO ./xpm/38b4a7d6673ca3009f95755fd993e1f3-_1__1.xpm
SO ./xpm/ground1.xpm
WE ./xpm/38b4a7d6673ca3009f95755fd993e1f3-_1__1.xpm
EA ./xpm/ground1.xpm
F 165,42,42
C 0,255, 0
111111111111111111111111111111111111111
100000000000000000000000000000000000001
100000000000000000000000000000000000001
100000000000000000000000000000000000001
100000000000000000000000000000000000001
100000000000000000101010100000000000001
100000000000000100000000000000000000001
100000000000000000000000000000000000001
100000000000000000000000000000000000001
100000000000000000000000000000000000001
100000000000000N00000000000000000000001
100000000000000000000000000000000000001
100000000000000000000000000000000000001
100000000000000000000000000000000000001
100000000000000000000000000000000000001
100000000000000000000000000000000000001
100000000000000000000000000000000000001
100000000000000000000000000000000000001
100000000000000000000000000000000000001
100000000000000000000000000000000000001
100000000000000000000000000000000000001
111111111111111111111111111111111111111
