NO ./xpm/wall1.xpm
SO ./xpm/collectible1.xpm
WE ./xpm/exit1.xpm
EA ./xpm/player1.xpm
F 220,100,0
C 225,30,0
111111111111111111111111111111111111111
100000000000000000000000000000000000001
100000000000000000000000000000000000001
100000000000000000000000000000000000001
100000000000000000000000000000000000001
100000000000000000101010100000000000001
100000000000000100000000000000000000001
100000000000000000000000000000000000001
100000000000000000000000000000000000001
100000000000100N00000000000000000000001
100000000000000000000000000000000000001
100000000000000000000000000000000000001
100000000000000000000000000000000000001
100000000000000000000000000000000000001
100000000000000000000000000000000000001
100000000000000000000000000000000000001
100000000000000000000000000000000000001
100000000000000000000000000000000000001
100000000000000000000000000000000000001
100000000000000000000000000000000000001
100000000000000000000000000000000000001
111111111111111111111111111111111111111
